0
+--+--+--+--+--+--+--+--+--+--+
                  |     |     |
                  |     |     |
+--+--+--+--+--+  +  +  +  +--+
|                 |  |  |     |
|                 |  |  |     |
+  +--+--+--+--+--+  +  +--+  +
|  |     |           |     |  |
|  |     |           |     |  |
+  +  +  +  +--+--+--+--+  +  +
|  |  |  |     |     |        |
|  |  |  |     |     |        |
+  +  +  +--+  +  +  +--+--+--+
|  |  |     |  |  |           |
|  |  |     |  |  |           |
+  +  +--+  +  +  +--+--+--+  +
|  |  |  |  |     |        |  |
|  |  |  |  |     |        |  |
+  +  +  +  +--+--+  +--+--+  +
|     |     |                 |
|     |     |                 |
+--+  +  +--+--+--+  +  +  +--+
|     |  |  |     |  |  |  |* |
|     |  |  |     |  |  |  |  |
+  +--+  +  +  +  +  +  +  +  +
|     |     |  |  |  |  |  |  |
|     |     |  |  |  |  |  |  |
+  +--+--+--+  +  +  +  +  +  +
|              |     |  |      
|              |     |  |      
+--+--+--+--+--+--+--+--+--+--+
