0
+--+--+--+--+--+--+--+
         |  |        |
         |  |        |
+--+--+  +  +  +  +  +
|     |  |  |  |  |  |
|     |  |  |  |  |  |
+  +  +  +  +  +  +--+
|  |  |  |     |     |
|  |  |  |     |     |
+  +  +  +--+--+--+  +
|  |                 |
|  |                 |
+  +--+--+--+--+--+--+
|  |        |        |
|  |        |        |
+  +--+--+  +--+  +  +
|  |     |  |     |  |
|  |     |  |     |  |
+  +  +  +  +  +--+  +
|  |  |     |  |     |
|  |  |     |  |     |
+  +  +--+--+  +  +--+
|  |  |        |  |  |
|  |  |        |  |  |
+  +  +--+--+--+  +  +
|     |        |     |
|     |        |     |
+--+  +  +--+  +  +--+
|     |  |  |  |     |
|     |  |  |  |     |
+  +--+  +  +  +  +  +
|  |  |  |     |  |  |
|  |  |  |     |  |  |
+  +  +  +  +--+  +  +
|  |     |  |     |  |
|  |     |  |     |  |
+  +  +--+  +  +--+--+
|  |  |     |        |
|  |  |     |        |
+  +  +  +--+--+--+  +
|  |  |              |
|  |  |              |
+  +  +--+  +--+--+--+
|        |           *
|        |            
+--+--+--+--+--+--+--+
