0
+--+--+--+--+--+--+--+--+--+--+
   |     |        |           |
   |     |        |           |
+  +  +  +  +  +--+  +  +--+  +
|  |  |  |  |  |     |  |     |
|  |  |  |  |  |     |  |     |
+  +  +  +  +  +  +--+  +  +--+
|  |  |     |  |     |  |     |
|  |  |     |  |     |  |     |
+  +  +--+  +--+--+  +--+--+  +
|     |        |     |        |
|     |        |     |        |
+--+--+--+--+  +  +--+  +--+--+
|     |           |           |
|     |           |           |
+  +  +  +--+  +--+  +--+--+--+
|  |  |  |     |        |     |
|  |  |  |     |        |     |
+  +  +--+  +--+--+--+  +  +  +
|  |        |        |     |  |
|  |        |        |     |  |
+  +--+--+--+--+--+  +--+--+--+
|                             |
|                             |
+--+--+--+--+--+--+--+--+--+  +
|     |  |     |     |     |  |
|     |  |     |     |     |  |
+  +  +  +  +  +  +  +  +--+  +
|  |     |  |     |     |     |
|  |     |  |     |     |     |
+--+  +  +  +--+--+--+--+  +--+
|     |  |        |        |  |
|     |  |        |        |  |
+  +--+  +--+  +--+  +--+--+  +
|     |        |     |     |  |
|     |        |     |     |  |
+--+  +--+--+  +  +--+  +  +  +
|           |     |     |     |
|           |     |     |     |
+  +--+--+  +--+--+  +  +--+--+
|  |     |           |  |     |
|  |     |           |  |     |
+  +--+  +--+--+--+--+--+  +  +
|                          |  *
|                          |   
+--+--+--+--+--+--+--+--+--+--+
