0
+----+----+----+----+----+----+----+----+----+----+----+----+----+----+----+
                    |    |                        |                        |
                    |    |                        |                        |
                    |    |                        |          *             |
                    |    |                        |                        |
+----+----+----+    +    +    +----+----+----+    +----+    +----+----+    +
|                        |                   |    |         |              |
|                        |                   |    |         |              |
|                        |                   |    |         |              |
|                        |                   |    |         |              |
+    +----+----+----+----+----+----+----+    +----+    +----+    +----+    +
|    |                        |         |         |         |    |         |
|    |                        |         |         |         |    |         |
|    |                        |         |         |         |    |         |
|    |                        |         |         |         |    |         |
+    +    +----+----+----+    +    +    +----+    +----+    +    +----+----+
|    |                   |         |    |                   |              |
|    |                   |         |    |                   |              |
|    |                   |         |    |                   |              |
|    |                   |         |    |                   |              |
+    +----+----+    +----+----+----+    +    +----+    +----+----+----+    +
|         |         |              |    |    |         |         |         |
|         |         |              |    |    |         |         |         |
|         |         |              |    |    |         |         |         |
|         |         |              |    |    |         |         |         |
+----+    +    +----+    +----+----+    +    +    +----+    +----+    +----+
|    |    |              |              |    |    |    |              |    |
|    |    |              |              |    |    |    |              |    |
|    |    |              |              |    |    |    |              |    |
|    |    |              |              |    |    |    |              |    |
+    +    +----+----+----+    +----+    +    +    +    +----+    +----+    +
|         |                   |    |         |         |    |              |
|         |                   |    |         |         |    |              |
|         |                   |    |         |         |    |              |
|         |                   |    |         |         |    |              |
+    +----+    +----+    +----+    +----+----+----+----+    +----+----+----+
|    |              |                                  |    |              |
|    |              |                                  |    |              |
|    |              |                                  |    |              |
|    |              |                                  |    |              |
+    +    +    +----+----+----+----+----+----+    +    +    +    +    +----+
|         |    |         |         |              |    |    |    |         |
|         |    |         |         |              |    |    |    |         |
|         |    |         |         |              |    |    |    |         |
|         |    |         |         |              |    |    |    |         |
+----+----+    +    +----+    +    +    +----+----+    +    +    +----+    +
|              |              |         |                        |          
|              |              |         |                        |          
|              |              |         |                        |          
|              |              |         |                        |          
+----+----+----+----+----+----+----+----+----+----+----+----+----+----+----+
