0
+--+--+--+--+
         |* |
+  +  +--+  +
|           |
+--+--+  +--+
|     |     |
+  +  +--+  +
|  |        +
+--+--+--+--+
