3
+--+--+--+--+
   |     |  |
+  +  +  +  +
|     |     |
+--+--+  +--+
|     |     |
+  +  +--+  +
|  |        *
+--+--+--+--+
