0
+--+--+--+--+--+
      |*       |
      |        |
+  +  +--+--+  +
|  |        |  |
|  |        |  |
+  +--+--+  +  +
|        |     |
|        |     |
+--+--+  +--+--+
|     |     |  |
|     |     |  |
+  +  +  +  +  +
|  |     |      
|  |     |      
+--+--+--+--+--+
