0
+--+--+--+--+--+--+
      |     |     |
      |     |     |
+--+  +  +  +--+  +
|  |     |     |  |
|  |     |     |  |
+  +--+--+--+  +  +
|  |     |     |  |
|  |     |     |  |
+  +  +  +  +--+  +
|     |           |
|     |           |
+--+--+  +--+--+--+
|        |        |
|        |        |
+  +--+--+  +--+  +
|           |     *
|           |      
+--+--+--+--+--+--+
