0
+--+--+--+--+--+--+--+--+--+--+--+--+
   |     |     |  |     |           |
+  +  +  +--+  +  +  +  +--+  +--+  +
|  |  |     |  |     |     |  |     |
+  +  +--+  +  +--+--+--+  +  +  +--+
|  |     |  |        |     |  |     |
+  +--+  +  +--+--+  +  +--+--+--+  +
|     |  |     |  |        |        |
+--+  +  +--+  +  +--+--+  +  +  +  +
|     |     |        |     |  |  |  |
+  +--+--+--+--+  +  +  +--+  +  +--+
|        |     |  |  |  |     |     |
+--+--+  +  +  +  +--+  +  +--+--+  +
|     |  |  |  |     |  |  |        |
+  +  +  +  +  +--+  +  +--+  +--+--+
|  |        |        |     |     |  |
+  +--+  +--+--+--+--+--+  +--+  +  +
|     |     |     |        |        |
+  +  +--+  +  +  +  +--+--+--+--+  +
|  |     |     |  |  |     |     |  |
+  +--+  +--+--+  +  +  +--+  +  +  +
|     |  |        |  |     |  |     |
+  +--+  +  +--+--+  + *+  +  +  +--+
|  |     |     |     |  |     |     |
+  +  +--+--+  +  +--+  +--+--+--+  +
|  |  |     |  |        |        |  |
+--+  +  +  +--+--+  +--+  +--+  +  +
|     |  |  |           |     |  |  |
+  +--+  +  +  +--+--+  +--+  +--+  +
|        |     |        |            
+--+--+--+--+--+--+--+--+--+--+--+--+
