2
+----+----+----+----+----+----+----+----+----+----+----+----+----+----+----+
                    |                        |         |         |         |
                    |                        |         |         |*        |
+----+----+    +    +    +    +----+----+    +    +    +    +    +----+    +
|         |    |    |    |    |         |    |    |    |    |         |    |
|         |    |    |    |    |         |    |    |    |    |         |    |
+    +    +    +    +    +----+    +    +    +    +    +    +----+    +    +
|    |    |    |    |         |    |         |    |    |         |    |    |
|    |    |    |    |         |    |         |    |    |         |    |    |
+    +    +    +----+----+    +    +----+----+    +    +----+    +    +    +
|    |         |         |    |    |    |         |         |    |         |
|    |         |         |    |    |    |         |         |    |         |
+    +----+----+    +    +    +    +    +    +----+    +    +----+    +----+
|    |              |         |    |    |    |    |    |         |         |
|    |              |         |    |    |    |    |    |         |         |
+    +    +----+----+----+    +    +    +    +    +    +----+    +    +----+
|    |    |                   |    |              |         |    |         |
|    |    |                   |    |              |         |    |         |
+    +    +    +----+----+----+    +    +----+----+----+    +    +    +    +
|         |                   |         |                   |         |     
|         |                   |         |                   |         |     
+----+----+----+----+----+----+----+----+----+----+----+----+----+----+----+
