0
+--+--+--+--+--+--+--+--+--+--+--+--+--+
      |     |        |  |              |
+  +--+  +  +  +  +  +  +  +--+--+--+  +
|  |     |  |  |  |     |  |     |     |
+  +  +--+  +--+  +  +--+  +--+  +  +  +
|  |  |     |     |     |     |     |  |
+  +  +  +--+  +--+  +  +--+  +--+--+  +
|     |     |  |     |        |     |  |
+--+--+  +  +  +  +--+--+--+--+--+  +  +
|  |     |     |  |        |     |     |
+  +  +--+--+--+  +--+--+  +--+  +--+--+
|  |  |        |        |     |  |     |
+  +  +  +--+  +--+--+  +--+  +  +  +  +
|  |     |  |     |     |  |  |     |  |
+  +--+--+  +--+  +--+--+  +  +  +--+  +
|        |     |     |     |        |  |
+  +--+  +  +  +--+  +  +  +--+--+  +--+
|     |     |        |  |  |          *|
+--+  +--+--+--+--+--+--+  +  +--+--+  +
|     |           |        |  |        |
+--+  +  +--+--+  +  +  +--+  +  +--+--+
|     |  |        |  |        |  |     |
+  +--+  +  +  +--+  +--+--+--+  +--+  +
|        |  |        |     |     |     |
+--+  +--+--+--+--+--+--+  +  +  +  +--+
|     |     |     |           |  |  |  |
+  +--+--+  +  +--+  +--+--+--+--+  +  +
|           |                           
+--+--+--+--+--+--+--+--+--+--+--+--+--+
